district,observation,isolation,total_hospitalized,hospitalized_today,
Thiruvananthapuram,226,208,18,13,
Kollam,324,312,12,3,
Pathanamthitta,932,903,29,5,
Idukki,52,52,0,0,
Kottayam,736,725,11,2,
Alappuzha,265,252,13,7,
Ernakulam,437,407,30,1,
Thrissur,1150,1078,72,5,
Palakkad,146,124,22,7,
Malappuram,165,135,30,1,
Kozhikode,592,585,7,4,
Wayanad,57,57,0,0,
Kannur,181,158,23,16,
Kasaragod,205,195,10,5,
Total,5468,5191,277,69,
